#####################
#####################
###AA###MM#######II##
#                   #
#                   #
<                   >
######          ### #
#  # #          #   #
#               #   #
#####################
0
<|1|1|5
>|1|17|5