18 10 room1.png
##################
##################
###AA#########II##
#     #     #    #
#     #######    #
<                >
#       2        #
#   1            #
#                #
##################
2
<|2|5|5
>|2|6|6
2
1|0|Хрень какая-то
2|0|тоже хрень какая-то